Cromossomo: 4-6-5-5-5-4-5-4-5-5-7-5-3-5-5-2-6-3-7-5-1-6-4-4-2-2-7-4-2-5-3-3-7-4-6-1-5-2-4-3-1-6-7-7-7-2-5-4-6-3-1-2-7-2-1-2-7-
Ponto: (1,1):
E 0 0 0 0 0 0 0 1 1 
1 $ 0 1 0 1 0 0 0 0 
0 0 0 1 0 1 0 0 1 0 
0 0 0 1 1 1 1 1 1 0 
0 1 0 0 0 0 0 0 1 0 
0 1 1 1 1 1 1 0 1 0 
0 0 0 0 0 0 0 0 1 0 
1 0 0 1 1 0 1 1 0 0 
1 1 0 1 1 0 1 1 0 1 
1 1 S 0 0 0 1 1 0 1 
Ponto: (2,0):
E 0 0 0 0 0 0 0 1 1 
1 $ 0 1 0 1 0 0 0 0 
$ 0 0 1 0 1 0 0 1 0 
0 0 0 1 1 1 1 1 1 0 
0 1 0 0 0 0 0 0 1 0 
0 1 1 1 1 1 1 0 1 0 
0 0 0 0 0 0 0 0 1 0 
1 0 0 1 1 0 1 1 0 0 
1 1 0 1 1 0 1 1 0 1 
1 1 S 0 0 0 1 1 0 1 
Ponto: (3,0):
E 0 0 0 0 0 0 0 1 1 
1 $ 0 1 0 1 0 0 0 0 
$ 0 0 1 0 1 0 0 1 0 
$ 0 0 1 1 1 1 1 1 0 
0 1 0 0 0 0 0 0 1 0 
0 1 1 1 1 1 1 0 1 0 
0 0 0 0 0 0 0 0 1 0 
1 0 0 1 1 0 1 1 0 0 
1 1 0 1 1 0 1 1 0 1 
1 1 S 0 0 0 1 1 0 1 
Ponto: (4,0):
E 0 0 0 0 0 0 0 1 1 
1 $ 0 1 0 1 0 0 0 0 
$ 0 0 1 0 1 0 0 1 0 
$ 0 0 1 1 1 1 1 1 0 
$ 1 0 0 0 0 0 0 1 0 
0 1 1 1 1 1 1 0 1 0 
0 0 0 0 0 0 0 0 1 0 
1 0 0 1 1 0 1 1 0 0 
1 1 0 1 1 0 1 1 0 1 
1 1 S 0 0 0 1 1 0 1 
Ponto: (5,0):
E 0 0 0 0 0 0 0 1 1 
1 $ 0 1 0 1 0 0 0 0 
$ 0 0 1 0 1 0 0 1 0 
$ 0 0 1 1 1 1 1 1 0 
$ 1 0 0 0 0 0 0 1 0 
$ 1 1 1 1 1 1 0 1 0 
0 0 0 0 0 0 0 0 1 0 
1 0 0 1 1 0 1 1 0 0 
1 1 0 1 1 0 1 1 0 1 
1 1 S 0 0 0 1 1 0 1 
Ponto: (6,1):
E 0 0 0 0 0 0 0 1 1 
1 $ 0 1 0 1 0 0 0 0 
$ 0 0 1 0 1 0 0 1 0 
$ 0 0 1 1 1 1 1 1 0 
$ 1 0 0 0 0 0 0 1 0 
$ 1 1 1 1 1 1 0 1 0 
0 $ 0 0 0 0 0 0 1 0 
1 0 0 1 1 0 1 1 0 0 
1 1 0 1 1 0 1 1 0 1 
1 1 S 0 0 0 1 1 0 1 
Ponto: (7,1):
E 0 0 0 0 0 0 0 1 1 
1 $ 0 1 0 1 0 0 0 0 
$ 0 0 1 0 1 0 0 1 0 
$ 0 0 1 1 1 1 1 1 0 
$ 1 0 0 0 0 0 0 1 0 
$ 1 1 1 1 1 1 0 1 0 
0 $ 0 0 0 0 0 0 1 0 
1 $ 0 1 1 0 1 1 0 0 
1 1 0 1 1 0 1 1 0 1 
1 1 S 0 0 0 1 1 0 1 
Ponto: (8,2):
E 0 0 0 0 0 0 0 1 1 
1 $ 0 1 0 1 0 0 0 0 
$ 0 0 1 0 1 0 0 1 0 
$ 0 0 1 1 1 1 1 1 0 
$ 1 0 0 0 0 0 0 1 0 
$ 1 1 1 1 1 1 0 1 0 
0 $ 0 0 0 0 0 0 1 0 
1 $ 0 1 1 0 1 1 0 0 
1 1 $ 1 1 0 1 1 0 1 
1 1 S 0 0 0 1 1 0 1 
Ponto: (9,2):
E 0 0 0 0 0 0 0 1 1 
1 $ 0 1 0 1 0 0 0 0 
$ 0 0 1 0 1 0 0 1 0 
$ 0 0 1 1 1 1 1 1 0 
$ 1 0 0 0 0 0 0 1 0 
$ 1 1 1 1 1 1 0 1 0 
0 $ 0 0 0 0 0 0 1 0 
1 $ 0 1 1 0 1 1 0 0 
1 1 $ 1 1 0 1 1 0 1 
1 1 $ 0 0 0 1 1 0 1 
