Cromossomo: 3-4-2-3-5-2-4-4-2-4-5-2-4-6-6-6-2-4-6-5-1-1-4-1-2-1-4-3-1-7-4-5-3-5-4-6-1-1-5-1-7-2-1-2-2-1-2-3-1-7-5-1-1-4-4-4-7-
Ponto: (0,1):
E $ 0 0 0 0 0 0 1 1 
1 0 0 1 0 1 0 0 0 0 
0 0 0 1 0 1 0 0 1 0 
0 0 0 1 1 1 1 1 1 S 
0 1 0 0 0 0 0 0 1 0 
0 1 1 1 1 1 1 0 1 0 
0 0 0 0 0 0 0 0 1 0 
1 0 0 1 1 0 1 1 0 0 
1 1 0 1 1 0 1 1 0 1 
1 1 0 0 0 0 1 1 0 1 
Ponto: (1,2):
E $ 0 0 0 0 0 0 1 1 
1 0 $ 1 0 1 0 0 0 0 
0 0 0 1 0 1 0 0 1 0 
0 0 0 1 1 1 1 1 1 S 
0 1 0 0 0 0 0 0 1 0 
0 1 1 1 1 1 1 0 1 0 
0 0 0 0 0 0 0 0 1 0 
1 0 0 1 1 0 1 1 0 0 
1 1 0 1 1 0 1 1 0 1 
1 1 0 0 0 0 1 1 0 1 
Ponto: (0,3):
E $ 0 $ 0 0 0 0 1 1 
1 0 $ 1 0 1 0 0 0 0 
0 0 0 1 0 1 0 0 1 0 
0 0 0 1 1 1 1 1 1 S 
0 1 0 0 0 0 0 0 1 0 
0 1 1 1 1 1 1 0 1 0 
0 0 0 0 0 0 0 0 1 0 
1 0 0 1 1 0 1 1 0 0 
1 1 0 1 1 0 1 1 0 1 
1 1 0 0 0 0 1 1 0 1 
Ponto: (0,4):
E $ 0 $ $ 0 0 0 1 1 
1 0 $ 1 0 1 0 0 0 0 
0 0 0 1 0 1 0 0 1 0 
0 0 0 1 1 1 1 1 1 S 
0 1 0 0 0 0 0 0 1 0 
0 1 1 1 1 1 1 0 1 0 
0 0 0 0 0 0 0 0 1 0 
1 0 0 1 1 0 1 1 0 0 
1 1 0 1 1 0 1 1 0 1 
1 1 0 0 0 0 1 1 0 1 
Ponto: (1,4):
E $ 0 $ $ 0 0 0 1 1 
1 0 $ 1 $ 1 0 0 0 0 
0 0 0 1 0 1 0 0 1 0 
0 0 0 1 1 1 1 1 1 S 
0 1 0 0 0 0 0 0 1 0 
0 1 1 1 1 1 1 0 1 0 
0 0 0 0 0 0 0 0 1 0 
1 0 0 1 1 0 1 1 0 0 
1 1 0 1 1 0 1 1 0 1 
1 1 0 0 0 0 1 1 0 1 
Ponto: (0,5):
E $ 0 $ $ $ 0 0 1 1 
1 0 $ 1 $ 1 0 0 0 0 
0 0 0 1 0 1 0 0 1 0 
0 0 0 1 1 1 1 1 1 S 
0 1 0 0 0 0 0 0 1 0 
0 1 1 1 1 1 1 0 1 0 
0 0 0 0 0 0 0 0 1 0 
1 0 0 1 1 0 1 1 0 0 
1 1 0 1 1 0 1 1 0 1 
1 1 0 0 0 0 1 1 0 1 
Ponto: (1,6):
E $ 0 $ $ $ 0 0 1 1 
1 0 $ 1 $ 1 $ 0 0 0 
0 0 0 1 0 1 0 0 1 0 
0 0 0 1 1 1 1 1 1 S 
0 1 0 0 0 0 0 0 1 0 
0 1 1 1 1 1 1 0 1 0 
0 0 0 0 0 0 0 0 1 0 
1 0 0 1 1 0 1 1 0 0 
1 1 0 1 1 0 1 1 0 1 
1 1 0 0 0 0 1 1 0 1 
Ponto: (2,7):
E $ 0 $ $ $ 0 0 1 1 
1 0 $ 1 $ 1 $ 0 0 0 
0 0 0 1 0 1 0 $ 1 0 
0 0 0 1 1 1 1 1 1 S 
0 1 0 0 0 0 0 0 1 0 
0 1 1 1 1 1 1 0 1 0 
0 0 0 0 0 0 0 0 1 0 
1 0 0 1 1 0 1 1 0 0 
1 1 0 1 1 0 1 1 0 1 
1 1 0 0 0 0 1 1 0 1 
Ponto: (1,8):
E $ 0 $ $ $ 0 0 1 1 
1 0 $ 1 $ 1 $ 0 $ 0 
0 0 0 1 0 1 0 $ 1 0 
0 0 0 1 1 1 1 1 1 S 
0 1 0 0 0 0 0 0 1 0 
0 1 1 1 1 1 1 0 1 0 
0 0 0 0 0 0 0 0 1 0 
1 0 0 1 1 0 1 1 0 0 
1 1 0 1 1 0 1 1 0 1 
1 1 0 0 0 0 1 1 0 1 
Ponto: (2,9):
E $ 0 $ $ $ 0 0 1 1 
1 0 $ 1 $ 1 $ 0 $ 0 
0 0 0 1 0 1 0 $ 1 $ 
0 0 0 1 1 1 1 1 1 S 
0 1 0 0 0 0 0 0 1 0 
0 1 1 1 1 1 1 0 1 0 
0 0 0 0 0 0 0 0 1 0 
1 0 0 1 1 0 1 1 0 0 
1 1 0 1 1 0 1 1 0 1 
1 1 0 0 0 0 1 1 0 1 
Ponto: (3,9):
E $ 0 $ $ $ 0 0 1 1 
1 0 $ 1 $ 1 $ 0 $ 0 
0 0 0 1 0 1 0 $ 1 $ 
0 0 0 1 1 1 1 1 1 $ 
0 1 0 0 0 0 0 0 1 0 
0 1 1 1 1 1 1 0 1 0 
0 0 0 0 0 0 0 0 1 0 
1 0 0 1 1 0 1 1 0 0 
1 1 0 1 1 0 1 1 0 1 
1 1 0 0 0 0 1 1 0 1 
