Cromossomo: 4-1-4-4-5-6-3-4-5-5-4-4-1-4-3-3-6-7-1-6-6-2-4-5-2-2-5-5-5-1-3-6-2-5-1-3-1-2-6-6-1-3-5-5-5-4-7-7-6-5-5-6-7-7-
Ponto: (1,1):
E 0 1 1 0 0 0 0 0 1 
1 $ 0 0 0 1 0 1 0 0 
0 0 0 0 1 1 0 0 1 1 
0 1 1 0 0 1 1 0 0 1 
0 0 0 0 0 1 1 0 1 1 
1 1 1 1 0 1 1 0 1 1 
1 0 1 1 0 1 1 0 0 0 
0 0 0 0 0 1 1 1 1 1 
1 0 1 0 0 0 0 0 1 1 
1 0 1 0 1 0 0 0 0 S 
Ponto: (0,1):
E $ 1 1 0 0 0 0 0 1 
1 $ 0 0 0 1 0 1 0 0 
0 0 0 0 1 1 0 0 1 1 
0 1 1 0 0 1 1 0 0 1 
0 0 0 0 0 1 1 0 1 1 
1 1 1 1 0 1 1 0 1 1 
1 0 1 1 0 1 1 0 0 0 
0 0 0 0 0 1 1 1 1 1 
1 0 1 0 0 0 0 0 1 1 
1 0 1 0 1 0 0 0 0 S 
Ponto: (1,2):
E $ 1 1 0 0 0 0 0 1 
1 $ $ 0 0 1 0 1 0 0 
0 0 0 0 1 1 0 0 1 1 
0 1 1 0 0 1 1 0 0 1 
0 0 0 0 0 1 1 0 1 1 
1 1 1 1 0 1 1 0 1 1 
1 0 1 1 0 1 1 0 0 0 
0 0 0 0 0 1 1 1 1 1 
1 0 1 0 0 0 0 0 1 1 
1 0 1 0 1 0 0 0 0 S 
Ponto: (2,3):
E $ 1 1 0 0 0 0 0 1 
1 $ $ 0 0 1 0 1 0 0 
0 0 0 $ 1 1 0 0 1 1 
0 1 1 0 0 1 1 0 0 1 
0 0 0 0 0 1 1 0 1 1 
1 1 1 1 0 1 1 0 1 1 
1 0 1 1 0 1 1 0 0 0 
0 0 0 0 0 1 1 1 1 1 
1 0 1 0 0 0 0 0 1 1 
1 0 1 0 1 0 0 0 0 S 
Ponto: (3,3):
E $ 1 1 0 0 0 0 0 1 
1 $ $ 0 0 1 0 1 0 0 
0 0 0 $ 1 1 0 0 1 1 
0 1 1 $ 0 1 1 0 0 1 
0 0 0 0 0 1 1 0 1 1 
1 1 1 1 0 1 1 0 1 1 
1 0 1 1 0 1 1 0 0 0 
0 0 0 0 0 1 1 1 1 1 
1 0 1 0 0 0 0 0 1 1 
1 0 1 0 1 0 0 0 0 S 
Ponto: (4,2):
E $ 1 1 0 0 0 0 0 1 
1 $ $ 0 0 1 0 1 0 0 
0 0 0 $ 1 1 0 0 1 1 
0 1 1 $ 0 1 1 0 0 1 
0 0 $ 0 0 1 1 0 1 1 
1 1 1 1 0 1 1 0 1 1 
1 0 1 1 0 1 1 0 0 0 
0 0 0 0 0 1 1 1 1 1 
1 0 1 0 0 0 0 0 1 1 
1 0 1 0 1 0 0 0 0 S 
Ponto: (4,3):
E $ 1 1 0 0 0 0 0 1 
1 $ $ 0 0 1 0 1 0 0 
0 0 0 $ 1 1 0 0 1 1 
0 1 1 $ 0 1 1 0 0 1 
0 0 $ $ 0 1 1 0 1 1 
1 1 1 1 0 1 1 0 1 1 
1 0 1 1 0 1 1 0 0 0 
0 0 0 0 0 1 1 1 1 1 
1 0 1 0 0 0 0 0 1 1 
1 0 1 0 1 0 0 0 0 S 
Ponto: (5,4):
E $ 1 1 0 0 0 0 0 1 
1 $ $ 0 0 1 0 1 0 0 
0 0 0 $ 1 1 0 0 1 1 
0 1 1 $ 0 1 1 0 0 1 
0 0 $ $ 0 1 1 0 1 1 
1 1 1 1 $ 1 1 0 1 1 
1 0 1 1 0 1 1 0 0 0 
0 0 0 0 0 1 1 1 1 1 
1 0 1 0 0 0 0 0 1 1 
1 0 1 0 1 0 0 0 0 S 
Ponto: (6,4):
E $ 1 1 0 0 0 0 0 1 
1 $ $ 0 0 1 0 1 0 0 
0 0 0 $ 1 1 0 0 1 1 
0 1 1 $ 0 1 1 0 0 1 
0 0 $ $ 0 1 1 0 1 1 
1 1 1 1 $ 1 1 0 1 1 
1 0 1 1 $ 1 1 0 0 0 
0 0 0 0 0 1 1 1 1 1 
1 0 1 0 0 0 0 0 1 1 
1 0 1 0 1 0 0 0 0 S 
Ponto: (7,4):
E $ 1 1 0 0 0 0 0 1 
1 $ $ 0 0 1 0 1 0 0 
0 0 0 $ 1 1 0 0 1 1 
0 1 1 $ 0 1 1 0 0 1 
0 0 $ $ 0 1 1 0 1 1 
1 1 1 1 $ 1 1 0 1 1 
1 0 1 1 $ 1 1 0 0 0 
0 0 0 0 $ 1 1 1 1 1 
1 0 1 0 0 0 0 0 1 1 
1 0 1 0 1 0 0 0 0 S 
Ponto: (8,5):
E $ 1 1 0 0 0 0 0 1 
1 $ $ 0 0 1 0 1 0 0 
0 0 0 $ 1 1 0 0 1 1 
0 1 1 $ 0 1 1 0 0 1 
0 0 $ $ 0 1 1 0 1 1 
1 1 1 1 $ 1 1 0 1 1 
1 0 1 1 $ 1 1 0 0 0 
0 0 0 0 $ 1 1 1 1 1 
1 0 1 0 0 $ 0 0 1 1 
1 0 1 0 1 0 0 0 0 S 
Ponto: (9,6):
E $ 1 1 0 0 0 0 0 1 
1 $ $ 0 0 1 0 1 0 0 
0 0 0 $ 1 1 0 0 1 1 
0 1 1 $ 0 1 1 0 0 1 
0 0 $ $ 0 1 1 0 1 1 
1 1 1 1 $ 1 1 0 1 1 
1 0 1 1 $ 1 1 0 0 0 
0 0 0 0 $ 1 1 1 1 1 
1 0 1 0 0 $ 0 0 1 1 
1 0 1 0 1 0 $ 0 0 S 
Ponto: (8,6):
E $ 1 1 0 0 0 0 0 1 
1 $ $ 0 0 1 0 1 0 0 
0 0 0 $ 1 1 0 0 1 1 
0 1 1 $ 0 1 1 0 0 1 
0 0 $ $ 0 1 1 0 1 1 
1 1 1 1 $ 1 1 0 1 1 
1 0 1 1 $ 1 1 0 0 0 
0 0 0 0 $ 1 1 1 1 1 
1 0 1 0 0 $ $ 0 1 1 
1 0 1 0 1 0 $ 0 0 S 
Ponto: (9,7):
E $ 1 1 0 0 0 0 0 1 
1 $ $ 0 0 1 0 1 0 0 
0 0 0 $ 1 1 0 0 1 1 
0 1 1 $ 0 1 1 0 0 1 
0 0 $ $ 0 1 1 0 1 1 
1 1 1 1 $ 1 1 0 1 1 
1 0 1 1 $ 1 1 0 0 0 
0 0 0 0 $ 1 1 1 1 1 
1 0 1 0 0 $ $ 0 1 1 
1 0 1 0 1 0 $ $ 0 S 
Ponto: (9,8):
E $ 1 1 0 0 0 0 0 1 
1 $ $ 0 0 1 0 1 0 0 
0 0 0 $ 1 1 0 0 1 1 
0 1 1 $ 0 1 1 0 0 1 
0 0 $ $ 0 1 1 0 1 1 
1 1 1 1 $ 1 1 0 1 1 
1 0 1 1 $ 1 1 0 0 0 
0 0 0 0 $ 1 1 1 1 1 
1 0 1 0 0 $ $ 0 1 1 
1 0 1 0 1 0 $ $ $ S 
Ponto: (9,9):
E $ 1 1 0 0 0 0 0 1 
1 $ $ 0 0 1 0 1 0 0 
0 0 0 $ 1 1 0 0 1 1 
0 1 1 $ 0 1 1 0 0 1 
0 0 $ $ 0 1 1 0 1 1 
1 1 1 1 $ 1 1 0 1 1 
1 0 1 1 $ 1 1 0 0 0 
0 0 0 0 $ 1 1 1 1 1 
1 0 1 0 0 $ $ 0 1 1 
1 0 1 0 1 0 $ $ $ $ 
