Cromossomo: 4-5-3-4-5-4-5-6-7-7-5-5-6-2-7-6-2-7-3-1-6-2-7-5-4-1-6-1-2-7-5-3-2-6-5-1-6-2-4-6-1-3-6-3-7-7-7-6-3-1-6-1-6-4-
Ponto: (1,1):
E 0 1 1 0 0 0 0 0 1 
1 $ 0 0 0 1 0 1 0 0 
0 0 0 0 1 1 0 0 1 1 
0 1 1 0 0 1 1 0 0 1 
0 0 0 0 0 1 1 0 1 1 
1 1 1 1 0 1 1 0 1 1 
1 0 1 1 0 1 1 0 0 0 
0 0 0 0 0 1 1 1 1 1 
1 0 1 0 0 0 0 0 1 1 
1 S 1 0 1 0 0 0 0 0 
Ponto: (2,1):
E 0 1 1 0 0 0 0 0 1 
1 $ 0 0 0 1 0 1 0 0 
0 $ 0 0 1 1 0 0 1 1 
0 1 1 0 0 1 1 0 0 1 
0 0 0 0 0 1 1 0 1 1 
1 1 1 1 0 1 1 0 1 1 
1 0 1 1 0 1 1 0 0 0 
0 0 0 0 0 1 1 1 1 1 
1 0 1 0 0 0 0 0 1 1 
1 S 1 0 1 0 0 0 0 0 
Ponto: (2,2):
E 0 1 1 0 0 0 0 0 1 
1 $ 0 0 0 1 0 1 0 0 
0 $ $ 0 1 1 0 0 1 1 
0 1 1 0 0 1 1 0 0 1 
0 0 0 0 0 1 1 0 1 1 
1 1 1 1 0 1 1 0 1 1 
1 0 1 1 0 1 1 0 0 0 
0 0 0 0 0 1 1 1 1 1 
1 0 1 0 0 0 0 0 1 1 
1 S 1 0 1 0 0 0 0 0 
Ponto: (3,3):
E 0 1 1 0 0 0 0 0 1 
1 $ 0 0 0 1 0 1 0 0 
0 $ $ 0 1 1 0 0 1 1 
0 1 1 $ 0 1 1 0 0 1 
0 0 0 0 0 1 1 0 1 1 
1 1 1 1 0 1 1 0 1 1 
1 0 1 1 0 1 1 0 0 0 
0 0 0 0 0 1 1 1 1 1 
1 0 1 0 0 0 0 0 1 1 
1 S 1 0 1 0 0 0 0 0 
Ponto: (4,3):
E 0 1 1 0 0 0 0 0 1 
1 $ 0 0 0 1 0 1 0 0 
0 $ $ 0 1 1 0 0 1 1 
0 1 1 $ 0 1 1 0 0 1 
0 0 0 $ 0 1 1 0 1 1 
1 1 1 1 0 1 1 0 1 1 
1 0 1 1 0 1 1 0 0 0 
0 0 0 0 0 1 1 1 1 1 
1 0 1 0 0 0 0 0 1 1 
1 S 1 0 1 0 0 0 0 0 
Ponto: (5,4):
E 0 1 1 0 0 0 0 0 1 
1 $ 0 0 0 1 0 1 0 0 
0 $ $ 0 1 1 0 0 1 1 
0 1 1 $ 0 1 1 0 0 1 
0 0 0 $ 0 1 1 0 1 1 
1 1 1 1 $ 1 1 0 1 1 
1 0 1 1 0 1 1 0 0 0 
0 0 0 0 0 1 1 1 1 1 
1 0 1 0 0 0 0 0 1 1 
1 S 1 0 1 0 0 0 0 0 
Ponto: (6,4):
E 0 1 1 0 0 0 0 0 1 
1 $ 0 0 0 1 0 1 0 0 
0 $ $ 0 1 1 0 0 1 1 
0 1 1 $ 0 1 1 0 0 1 
0 0 0 $ 0 1 1 0 1 1 
1 1 1 1 $ 1 1 0 1 1 
1 0 1 1 $ 1 1 0 0 0 
0 0 0 0 0 1 1 1 1 1 
1 0 1 0 0 0 0 0 1 1 
1 S 1 0 1 0 0 0 0 0 
Ponto: (7,3):
E 0 1 1 0 0 0 0 0 1 
1 $ 0 0 0 1 0 1 0 0 
0 $ $ 0 1 1 0 0 1 1 
0 1 1 $ 0 1 1 0 0 1 
0 0 0 $ 0 1 1 0 1 1 
1 1 1 1 $ 1 1 0 1 1 
1 0 1 1 $ 1 1 0 0 0 
0 0 0 $ 0 1 1 1 1 1 
1 0 1 0 0 0 0 0 1 1 
1 S 1 0 1 0 0 0 0 0 
Ponto: (7,2):
E 0 1 1 0 0 0 0 0 1 
1 $ 0 0 0 1 0 1 0 0 
0 $ $ 0 1 1 0 0 1 1 
0 1 1 $ 0 1 1 0 0 1 
0 0 0 $ 0 1 1 0 1 1 
1 1 1 1 $ 1 1 0 1 1 
1 0 1 1 $ 1 1 0 0 0 
0 0 $ $ 0 1 1 1 1 1 
1 0 1 0 0 0 0 0 1 1 
1 S 1 0 1 0 0 0 0 0 
Ponto: (7,1):
E 0 1 1 0 0 0 0 0 1 
1 $ 0 0 0 1 0 1 0 0 
0 $ $ 0 1 1 0 0 1 1 
0 1 1 $ 0 1 1 0 0 1 
0 0 0 $ 0 1 1 0 1 1 
1 1 1 1 $ 1 1 0 1 1 
1 0 1 1 $ 1 1 0 0 0 
0 $ $ $ 0 1 1 1 1 1 
1 0 1 0 0 0 0 0 1 1 
1 S 1 0 1 0 0 0 0 0 
Ponto: (8,1):
E 0 1 1 0 0 0 0 0 1 
1 $ 0 0 0 1 0 1 0 0 
0 $ $ 0 1 1 0 0 1 1 
0 1 1 $ 0 1 1 0 0 1 
0 0 0 $ 0 1 1 0 1 1 
1 1 1 1 $ 1 1 0 1 1 
1 0 1 1 $ 1 1 0 0 0 
0 $ $ $ 0 1 1 1 1 1 
1 $ 1 0 0 0 0 0 1 1 
1 S 1 0 1 0 0 0 0 0 
Ponto: (9,1):
E 0 1 1 0 0 0 0 0 1 
1 $ 0 0 0 1 0 1 0 0 
0 $ $ 0 1 1 0 0 1 1 
0 1 1 $ 0 1 1 0 0 1 
0 0 0 $ 0 1 1 0 1 1 
1 1 1 1 $ 1 1 0 1 1 
1 0 1 1 $ 1 1 0 0 0 
0 $ $ $ 0 1 1 1 1 1 
1 $ 1 0 0 0 0 0 1 1 
1 $ 1 0 1 0 0 0 0 0 
