Cromossomo: 4-4-5-4-3-3-3-3-2-2-7-4-1-3-7-5-7-7-6-3-3-5-2-2-5-3-3-3-5-1-7-5-1-5-1-3-7-6-2-4-3-5-6-3-4-3-1-7-7-7-1-4-2-1-2-1-3-
Ponto: (1,1):
E 0 0 0 0 0 0 0 1 1 
1 $ 0 1 0 1 0 0 0 0 
0 0 0 1 0 1 0 0 1 0 
0 0 0 1 1 1 1 1 1 0 
0 1 0 0 0 0 0 S 1 0 
0 1 1 1 1 1 1 0 1 0 
0 0 0 0 0 0 0 0 1 0 
1 0 0 1 1 0 1 1 0 0 
1 1 0 1 1 0 1 1 0 1 
1 1 0 0 0 0 1 1 0 1 
Ponto: (2,2):
E 0 0 0 0 0 0 0 1 1 
1 $ 0 1 0 1 0 0 0 0 
0 0 $ 1 0 1 0 0 1 0 
0 0 0 1 1 1 1 1 1 0 
0 1 0 0 0 0 0 S 1 0 
0 1 1 1 1 1 1 0 1 0 
0 0 0 0 0 0 0 0 1 0 
1 0 0 1 1 0 1 1 0 0 
1 1 0 1 1 0 1 1 0 1 
1 1 0 0 0 0 1 1 0 1 
Ponto: (3,2):
E 0 0 0 0 0 0 0 1 1 
1 $ 0 1 0 1 0 0 0 0 
0 0 $ 1 0 1 0 0 1 0 
0 0 $ 1 1 1 1 1 1 0 
0 1 0 0 0 0 0 S 1 0 
0 1 1 1 1 1 1 0 1 0 
0 0 0 0 0 0 0 0 1 0 
1 0 0 1 1 0 1 1 0 0 
1 1 0 1 1 0 1 1 0 1 
1 1 0 0 0 0 1 1 0 1 
Ponto: (4,3):
E 0 0 0 0 0 0 0 1 1 
1 $ 0 1 0 1 0 0 0 0 
0 0 $ 1 0 1 0 0 1 0 
0 0 $ 1 1 1 1 1 1 0 
0 1 0 $ 0 0 0 S 1 0 
0 1 1 1 1 1 1 0 1 0 
0 0 0 0 0 0 0 0 1 0 
1 0 0 1 1 0 1 1 0 0 
1 1 0 1 1 0 1 1 0 1 
1 1 0 0 0 0 1 1 0 1 
Ponto: (4,4):
E 0 0 0 0 0 0 0 1 1 
1 $ 0 1 0 1 0 0 0 0 
0 0 $ 1 0 1 0 0 1 0 
0 0 $ 1 1 1 1 1 1 0 
0 1 0 $ $ 0 0 S 1 0 
0 1 1 1 1 1 1 0 1 0 
0 0 0 0 0 0 0 0 1 0 
1 0 0 1 1 0 1 1 0 0 
1 1 0 1 1 0 1 1 0 1 
1 1 0 0 0 0 1 1 0 1 
Ponto: (4,5):
E 0 0 0 0 0 0 0 1 1 
1 $ 0 1 0 1 0 0 0 0 
0 0 $ 1 0 1 0 0 1 0 
0 0 $ 1 1 1 1 1 1 0 
0 1 0 $ $ $ 0 S 1 0 
0 1 1 1 1 1 1 0 1 0 
0 0 0 0 0 0 0 0 1 0 
1 0 0 1 1 0 1 1 0 0 
1 1 0 1 1 0 1 1 0 1 
1 1 0 0 0 0 1 1 0 1 
Ponto: (4,6):
E 0 0 0 0 0 0 0 1 1 
1 $ 0 1 0 1 0 0 0 0 
0 0 $ 1 0 1 0 0 1 0 
0 0 $ 1 1 1 1 1 1 0 
0 1 0 $ $ $ $ S 1 0 
0 1 1 1 1 1 1 0 1 0 
0 0 0 0 0 0 0 0 1 0 
1 0 0 1 1 0 1 1 0 0 
1 1 0 1 1 0 1 1 0 1 
1 1 0 0 0 0 1 1 0 1 
Ponto: (4,7):
E 0 0 0 0 0 0 0 1 1 
1 $ 0 1 0 1 0 0 0 0 
0 0 $ 1 0 1 0 0 1 0 
0 0 $ 1 1 1 1 1 1 0 
0 1 0 $ $ $ $ $ 1 0 
0 1 1 1 1 1 1 0 1 0 
0 0 0 0 0 0 0 0 1 0 
1 0 0 1 1 0 1 1 0 0 
1 1 0 1 1 0 1 1 0 1 
1 1 0 0 0 0 1 1 0 1 
